NO ./path_to_the_north_texture
SO ./path_to_the_south_texture
WE ./path_to_the_west_texture
EA ./path_to_the_east_texture

F 52,162,35
C 81,209,246

        1111111111111111111111111
        1000000000000000000000001
        1000000000000001111111111
        1000000000N00001
111111111000000000000001
10000000000000000000000111111
10111111111111110000000000001
10000000000000000000000000001
10000111111111110000000000001
10000000000000000000000000001
10000000000000011111100000001
1000000111000001    100000001
10000001 1000001    100000001
11111111 1111111    111111111