NO ./path_to_the_north_texture
SO ./path_to_the_south_texture
WE ./path_to_the_west_texture
EA ./path_to_the_east_texture

F 220,100,0
C 225,30,0

                    1111111111111111111111111
                    1000000000110000000000001
                    1011000001110000111000001
                    1001000000000000000000001
                    1001000000000001111111111
   111111111111111111000000000010000000000001
   100000000000000000011000000110111111111111
   111111111100000000000000000000001
            10001011010110101000000111111
            10001011010111011101010000001
            11111111111111111111111110001111111111111111111111111
                                    10000000000000001100000010001
                                    10000000000000000001010000001
                            1111111110000001110101011111111111111
                            100000000000000000000001
                            100011111111111111000001
        1111111111111111111110001            1000001
        1001000000000000000000001            1000001
111111111011000001110000000000001            1000001
100000000011000001110111111011111            1111111
11110111111111011100000010001
11110111111111011101010010001
1100000011010101110000001000111111111111111111111111
1000000000000000000000001000000000000000000000000001
1000000000000000110101001000101111111111111111001001
1100000111010101111101111000111              1001N01
11110111 1110101 101101010001                1111111
11111111 1111111 111111111111