NO ./textures/wall1.png
SO ./textures/wall2.png
WE ./textures/wall3.png
EA ./textures/wall4.png

F 52,162,35
C 81,209,246

11111111         111111111
10000001         100000001
10000001111111111100000001
10000000000000000000000001
11111111111000111111111111
          10001
          10001
11111111111000111111111111
10101010101010101010101011
10000000000000000000000001
100000000000N0000000000001
11111111111111111111111111