NO ./path_to_the_north_texture
SO ./path_to_the_south_texture
WE ./path_to_the_west_texture
EA ./path_to_the_east_texture

F 220,100,0
C 225,30,0

            111111111111111111111111111111
        111110000000000000000000000001
        100000000111000000000000111111
        1001000000000000000000001
1111111110110000011100000000000011111111111
1000000000110000011101111111000000000000001
1011011111111101110000001000111111111111111
10110111111111011101010010001
10000000110101011100000010001
1000000000N000001100000010001
10000000000000000000010010001
1000000111010101111100000000111
10000001 1000001   1111111111
11111111 1111111 