NO ./textures/wall1.png
SO ./textures/wall2.png
WE ./textures/wall3.png
EA ./textures/wall4.png

F 52,162,35
C 81,209,246

11111111111111111111111111111
10000000000000000000000000001
10111111111111110000000000001
10000000000000000000000000001
10000111111111110000000000001
1000000000000000000000000N001
10000000000000000000000000001
11111111111111111111111111111