111111
10Q101
101001
1100N1
111111